PMID	Journal Title	#sentences	#not highlighted	#highlights	Paper Title
22019776	Neuropsychologia	441	430	11	./anns_v2/Ahn et al., (2011) - The cortical neuroanatomy of neuropsychological deficits in MCI and AD_annotated_ann.json
27670207	Can J Neurol Sci	161	149	12	./anns_v2/Altug et al., (2014) - Brain stimulation of subthalamic nucleus surgery on gait and balance in PD_annotated_ann.json
22940716	Eur Arch Psychiatry Clin Neurosci	170	156	14	./anns_v2/Arlt et al., (2013) - Association between MRI volumetry of brain regions and test performance in MCI and AD_annotated_ann.json
22180646	J Neurol Neurosurg Psychiatry	142	120	22	./anns_v2/Altug et al., (2011) - The influence of subthalamic nucleus DBS on daily living activities in PD_annotated_ann.json
21359972	J Neural Transm (Vienna)	94	88	6	./anns_v2/Allert et al., (2011) - Role of dysphagia in evaluating PD for STN-DBS._annotated_ann.json
27264343	Parkinsonism Relat Disord	137	128	9	./anns_v2/Arnaldi et al., (2016) - Functional neuroimaging and clinical features of drug naive patients with de novo PD and RBD_annotated_ann.json
20031272	Neurobiol Aging	184	172	12	./anns_v2/Avila et al., (2011) - Effect of temporal lobe structure volume on memory in eldery depressed patients_annotated_ann.json
25572161	J Neurol	126	107	19	./anns_v2/Benninger et al., (2008) - Morphological differences in PD with and without rest tremor_annotated_ann.json
None	None	182	166	16	./anns_v2/Beyer et al., (2006) - MRI study of PD with MCI and dementia using VBM_annotated_ann.json
20040773	J Ultrasound Med	114	101	13	./anns_v2/Bartova et al., (2010) - Correlation between substantia nigra features detected by sonography and PD_annotated_ann.json
26402108	J Alzheimers Dis	145	139	6	./anns_v2/Bilello et al., (2015) - Correlating cognitive decline with white matter lesions and atrophy in AD_annotated_ann.json
19632335	Neuroimage	220	209	11	./anns_v2/Birn et al., (2010) - Neural systems supporting lexical search guided by letter and semantic category cues. A self-paced overt response fMRI study of verbal fluency._annotated_ann.json
None	None	157	151	6	./anns_v2/Biundo et al., (2015) - Patterns of cortical thickness associated with ICD in PD_annotated_ann.json
25253863	J Neurosci	355	325	30	./anns_v2/Brandi et al., (2014) - The neural correlates of planning and executing actual tool use_annotated_ann.json
25240405	Parkinsonism Relat Disord	170	158	12	./anns_v2/Cerasa et al., (2014) - Cortical volume and folding abnormalities in PD with pathological gambling_annotated_ann.json
7964695	J Neural Transm Suppl	186	161	25	./anns_v2/Bologna et al., (2016) - Neural correlates of blinking abnormalities in patients with progressive supranuclear palsy_annotated_ann.json
24150105	J Alzheimers Dis	195	182	13	./anns_v2/Brugnolo et al., (2014) - Metabolic correlates of rey auditory verbal learning test in elderly subjects with memory complaints_annotated_ann.json
24817690	Mov Disord	176	167	9	./anns_v2/Carriere et al., (2014) - Apathy in PD associated with nucleus accumbens atrophy._annotated_ann.json
26717857	Parkinsonism Relat Disord	118	110	8	./anns_v2/Chung et al., (2016) - Apathy and striatal dopamine deficits in non-demented PD patients._annotated_ann.json
25165448	Front Aging Neurosci	232	217	15	./anns_v2/Chechko et al., (2014) - Neural correlates of unsuccessful memory performance in MCI_annotated_ann.json
27314757	J Parkinsons Dis	177	156	21	./anns_v2/Capelle et al., (2011) - DBS for camptocormia in dystonia and PD_annotated_ann.json
27452719	Neuropharmacology	169	153	16	./anns_v2/Cerasa et al., (2015) - The motor inbibition system in PD and dyskinesia_annotated_ann.json
21151376	Front Aging Neurosci	162	149	13	./anns_v2/Cotelli et al., (2010) - Action and object naming in physiological aging. An rTMS study_annotated_ann.json
19765737	J Neurol Sci	81	66	15	./anns_v2/Cicolin et al., (2004) - Effects of deep brain stimulation of STN on sleep archietecture in PD_annotated_ann.json
18418593	Eur J Nucl Med Mol Imaging	184	176	8	./anns_v2/Del Sole et al., (2008) - Individual cerebral metabolic deficits in AD and aMCI. An FDG PET study._annotated_ann.json
17785667	Neurology	252	228	24	./anns_v2/delpolyi et al., (2007) - Spatail cognition and the human navigation network in AD and MCI_annotated_ann.json
14614813	J Cogn Neurosci	242	224	18	./anns_v2/Coull et al., (1996) - A fronto-parietal network for RVIP_annotated_ann.json
24384308	Neuropsychologia	393	393	0	./anns_v2/Clark et al., (2014) - Lexical factors and cerebral regions influcing verbal fluency performance in MCI_annotated_ann.json
24286024	Neuroimage Clin	196	187	9	./anns_v2/Ewers et al., (2014) - Reduced FDG-PET brain metabolism and EF predict clinical progression in elderly healthy subjects_annotated_ann.json
24933580	Ann Neurol	228	216	12	./anns_v2/Dhanjal et al., (2014) - Frontoparietal cognitive control of verbal memory recall in AD_annotated_ann.json
27350397	J Neurosci Res	259	248	11	./anns_v2/Edison et al., (2007) - Amyloid, hypometabolism and cognition in AD_annotated_ann.json
11595262	Neuropsychologia	580	580	0	./anns_v2/Devlin et al., (2002) - Is there an anatomical basis for category-specificity. Semantic memory studies in PET and fMRI_annotated_ann.json
25596880	Parkinsonism Relat Disord	194	186	8	./anns_v2/Foki et al., (2015) - Finger dexterity deficits in PD_annotated_ann.json
21116054	J Alzheimers Dis	161	154	7	./anns_v2/Dos Santos et al., (2011) - Morphological cerebral correlates of CERAD test performance in AD and MCI_annotated_ann.json
None	None	201	196	5	./anns_v2/Florin et al., (2013) - Modulation of local field potential power of the subthalamic nucleus during isometric force generation in PD_annotated_ann.json
25361545	J Parkinsons Dis	121	107	14	./anns_v2/Erola et al., (2005) - Bilateral subthalamic nucleus stimulation improves health related quality of life in PD_annotated_ann.json
19247239	Med Sci Monit	17	15	2	./anns_v2/Formisano et al., (2009) - Blink reflex changes in PD following severe traumatic brain injury correlates with diffuse axonal injury_annotated_ann.json
10674796	Neuropsychology	400	383	17	./anns_v2/Fama et al., (2000) - Structural brain correlates of verbal and nonverbal fluency measures in AD_annotated_ann.json
21498904	J Alzheimers Dis	160	156	4	./anns_v2/Forster et al., (2011) - Effects of a 6 month cognitive intervention program on brain metabolism in aMCI and mild AD_annotated_ann.json
19875130	J Psychiatr Res	159	151	8	./anns_v2/Forster et al., (2010) - FDG-PET mapping the brain subtrates of visuoconstructive processing in AD_annotated_ann.json
8234569	Psychol Med	153	144	9	./anns_v2/Forstl et al., (1993) - Neuropathological basis for drawing disability (constructional apraxia) in Alzheimer's disease_annotated_ann.json
None	None	166	166	0	./anns_v2/Foster et al., (1986) - Cerebral mapping of apraxia in AD by PET_annotated_ann.json
27474916	Cortex	366	357	9	./anns_v2/Foxe et al., (2016) - The neural correlates of auditory and visuospatial span in logopenic progressive aphasia and AD_annotated_ann.json
None	None	180	152	28	./anns_v2/Garrido et al., (2002) - Relation between medial temporal atophy and functional braina activity during memory procressing in AD_annotated_ann.json
None	None	118	115	3	./anns_v2/Fuente-Fernandex et al., (2001) - Biochemical variations in the synaptic level of dopamine precede motor fluctuations in PD_annotated_ann.json
27060962	J Alzheimers Dis	213	200	13	./anns_v2/Gardini et al., (2015) - Increased functional connectivity in the DMN in MCI_annotated_ann.json
15351627	Neuropsychologia	139	124	15	./anns_v2/Gerton et al., (2004) - Shared and distinct neurophsyiological components of digits forward and backwards task._annotated_ann.json
9829454	Microsc Res Tech	154	154	0	./anns_v2/Giannakopoulous et al., (1998) - Pathologic correlates of apraxia in AD_annotated_ann.json
14697007	Acad Radiol	190	177	13	./anns_v2/Gee et al., (2003) - AD and FTD exhibit distinct atophy-behaviour correlates_annotated_ann.json
10963367	Acta Neuropathol	166	142	24	./anns_v2/Giannakopoulous et al., (2000) - Neural substrates of spatial and temporal disorientation in AD_annotated_ann.json
27516739	Front Aging Neurosci	375	364	11	./anns_v2/Genon et al., (2013) - Verbal learning in AD and MCI_annotated_ann.json
25281602	J Alzheimers Dis	177	177	0	./anns_v2/Gifford et al., (2015) - Subjective memory complaint only relates to verbal episodic memory performance in MCI_annotated_ann.json
25518957	Brain	177	158	19	./anns_v2/Giovannetti et al., (2001) - Different underlying mechanisms for deficits in concept formation in dementia_annotated_ann.json
21455719	Neuroradiology	141	134	7	./anns_v2/Goto et al., (2011) - Entorhinal cortex volume measured with 3T MRI is positively correlated with the Wechsler Memory Scale_annotated_ann.json
23740899	Sci Transl Med	219	219	0	./anns_v2/Grady et al., (2001) - Altered brain functional connectivity and impaired STM in AD_annotated_ann.json
19293396	Cereb Cortex	161	157	4	./anns_v2/Grogan et al., (2009) - Structural correlates of semantic and phonemic fluency ability_annotated_ann.json
26680084	Transplant Proc	303	287	16	./anns_v2/Hagell et al., (1999) - Sequential bilateral transplantation in PD_annotated_ann.json
None	None	496	496	0	./anns_v2/Grossman et al., (1996) - Progressive nonfluent aphasia. Language, cognitive and PET measures contrasted with AD_annotated_ann.json
None	None	102	97	5	./anns_v2/Han et al., (2015) - Functional neural correlates of figure copy and recall task performance in cognitively impaired individuals. An 18FFDG-PET study_annotated_ann.json
None	None	320	318	2	./anns_v2/Grossman et al., (2003) - Neural basis for semantic memory difficulty in AD_annotated_ann.json
21932265	Hum Brain Mapp	317	293	24	./anns_v2/Grasby et al., (1993) - Functional mapping of brain areas implicated in auditory-verbal memory function_annotated_ann.json
24450147	Seishin Shinkeigaku Zasshi	122	110	12	./anns_v2/Hanganu et al., (2013) - MCI in PD associated with increased cortical degeneration_annotated_ann.json
14761903	Brain	383	366	17	./anns_v2/Grossman et al., (2004) - Naming difficulty in AD, FTD and corticobasal degeneration._annotated_ann.json
8986328	Behav Neurosci	401	376	25	./anns_v2/Helkala et al., (1996) - Slow wave activity in the spectral analysis of the EEG and volumes of hippocampus in AD_annotated_ann.json
22663253	J Cogn Neurosci	184	173	11	./anns_v2/Heleen et al., (2012) - PET evidence for a role for striatal dopamine in the attentional blink_annotated_ann.json
21709375	J Alzheimers Dis	236	233	3	./anns_v2/Hanggi et al., (2011) - Volumes of lateral temporal and parietal structures distinguish between healthy aging, MCI and AD_annotated_ann.json
None	None	175	159	16	./anns_v2/Hellwig et al., (2013) - Neural correlates of cognitive dysfunction in LDB and tauopathies._annotated_ann.json
17351722	J Neurol	106	97	9	./anns_v2/Happe et al., (2007) - Association of daytime sleepiness with nigrostriatal dopaminergic degeneration in PD_annotated_ann.json
23864781	World J Gastroenterol	109	102	7	./anns_v2/Higginson et al., (2001) - Which symptoms of anxiety diminish after surgical interventions for PD_annotated_ann.json
19895200	J Neurosurg	116	103	13	./anns_v2/Hellman et al., (2008) - Effect of DBS on comptocormia and postural abnormalities in PD_annotated_ann.json
9854970	J Neurol Neurosurg Psychiatry	150	150	0	./anns_v2/Hirono et al., (1998) - Regional metabolism associations with dyscalculia in AD_annotated_ann.json
17977862	Brain	306	296	10	./anns_v2/Herzog et al., (2008) - Improved sensory gating of urinary bladder afferents in PD following subthalamic stimulation._annotated_ann.json
9576555	J Neurol Neurosurg Psychiatry	103	102	1	./anns_v2/Hirono et al., (1998) - Hypofunction in the posterior cingulate gyrus correlates with disorientation for time and place in AD_annotated_ann.json
23369803	Neuropsychologia	233	206	27	./anns_v2/Hirni et al., (2013) - Distinct neuroanatomical base of episodic and semantic memory performance in AD_annotated_ann.json
16725162	Neuropsychologia	280	275	5	./anns_v2/Hirshorn et al., (2006) - Role of the left infeiror frontal gyrus in covert word retrieval. Neural correlates of switching during verbal fluency_annotated_ann.json
27520750	Neuroimage	152	134	18	./anns_v2/Hu et al., (2015) - Amygdala associated with depression in PD_annotated_ann.json
None	None	138	127	11	./anns_v2/Hirono et al., (2001) - Neuronal substrates for semantic memory. A PET study in AD_annotated_ann.json
18821043	J Neurol	145	136	9	./anns_v2/Ibarretxe-Bilbao et al., (2007) - Hippocampal head atrophy predominance in PD with hallucinations and dementia._annotated_ann.json
12507726	Neurosci Res	113	107	6	./anns_v2/Ino et al., (2003) - Parieto-frontal networks for clock drawing revealed with fMRI_annotated_ann.json
None	None	144	138	6	./anns_v2/Hirono et al., 1998 - Regional metabolism. Associations with dyscalculia in AD_annotated_ann.json
21717194	J Neurol	175	165	10	./anns_v2/Janzen et al., (2012) - The PPN is related to VH in PD. Results from a VBM study._annotated_ann.json
11971059	J Neurol Neurosurg Psychiatry	165	148	17	./anns_v2/Iranzo et al., (2002) - Sleep symptoms and polysomnographic architecture in advanced PD after chronic bilateral STN stimulation_annotated_ann.json
26581788	J Int Neuropsychol Soc	238	223	15	./anns_v2/Kas et al., (2011) - Neural correlates of cognitive impairment in posterior cortical atrophy_annotated_ann.json
20110703	Dement Geriatr Cogn Disord	151	151	0	./anns_v2/Jessen et al., (2006) - Volume reduction of entorhinal cortex in subjective memory impairment_annotated_ann.json
15127084	Neuropsychopharmacology	231	223	8	./anns_v2/Johannsen et al., (1999) - Cortical responses to sustained and divided attention in AD_annotated_ann.json
19965847	J Neurol Neurosurg Psychiatry	315	305	10	./anns_v2/Ibarretxe-Bilbao et al., (2009) - Differential progression of brain atrophy in PD with and without VH_annotated_ann.json
None	None	198	175	23	./anns_v2/Kaiser et al., (2012) - Neuropsychological and neuroimaging markers in early vs. late onset AD_annotated_ann.json
21782309	Brain Cogn	326	326	0	./anns_v2/Jacobson et al., (2011) - An fMRI investigation of a novel analogue to the TMT_annotated_ann.json
None	None	232	222	10	./anns_v2/Kerchner et al., (2012) - Hippocampal CA1 apical neuopil atrophy and memory performance in AZ_annotated_ann.json
18313775	Arch Gerontol Geriatr	99	90	9	./anns_v2/Kim et al., (2009) - Relation between the clock drawing test and structural changes of brain in dementia._annotated_ann.json
None	None	109	103	6	./anns_v2/Kitabayashi et al., (2001) - Relationship between regional cerebral blood flow and VF in AD_annotated_ann.json
None	None	193	190	3	./anns_v2/Kalaitzakis et al., (2009) - Dementia and VH associated with limbi pathology in PD_annotated_ann.json
None	None	200	200	0	./anns_v2/Kircher et al., (2011) - Neural correlates of rhyming versus lexical and semantic fluency_annotated_ann.json
21850388	J Neurol	144	134	10	./anns_v2/Kato et al., (2012) - Widespread cortical and subcortical brain atrophy in PD with EDS_annotated_ann.json
9740363	Neuropsychologia	47	40	7	./anns_v2/Kohler et al., (1998) - Memory impairments associated with hippocampal versus parahippocampal-gyrus atrophy in AD_annotated_ann.json
10530725	Neuropsychologia	232	230	2	./anns_v2/Keilp et al., (1999) - Cerebral blood flow patterns underlying the differential impairment in category vs letter fluency in AD_annotated_ann.json
21389980	Neuropsychopharmacology	139	132	7	./anns_v2/Laakso et al., (2000) - Diagnosis of AD. MRI of hippocampus vs delayed recall_annotated_ann.json
26952698	Parkinsonism Relat Disord	170	163	7	./anns_v2/Krygowska-Wajs et al., (2016) - The effect of STN-DBS on gastric motility in PD._annotated_ann.json
25518957	Brain	237	212	25	./anns_v2/Lagarde et al., (2015) - Why do patients with neurodegenerative frontal syndrome fail to answer (In what way are an orange and banana alike)._annotated_ann.json
18841015	Dement Geriatr Cogn Disord	156	137	19	./anns_v2/Lee et al., (2008) - Neural correlates of CDT in AD using PET_annotated_ann.json
25361545	J Parkinsons Dis	112	100	12	./anns_v2/Lagrange et al., (2002) - Bilateral subthalamic nucleus stimulation improves health related quality of life in PD_annotated_ann.json
14614813	J Cogn Neurosci	207	197	10	./anns_v2/Lawrence et al., (2003) - Multiple neuronal networks mediate sustained attention_annotated_ann.json
10762504	Neurology	377	375	2	./anns_v2/Lehericy et al., (2000) - Functional MR evaluation of temporal and frontal language dominance compared with the Wada test_annotated_ann.json
25071613	Front Psychol	348	348	0	./anns_v2/Lee et al., (2014) - TMT in youth varies as a function of anatomical coupling between PFC and cortical regions_annotated_ann.json
24662100	J Alzheimers Dis	208	189	19	./anns_v2/Leyton et al., (2014) - Verbal repetition in PPA and AD_annotated_ann.json
12621318	Alzheimer Dis Assoc Disord	199	198	1	./anns_v2/Lekeu et al., (2003) - Brain correlates of performance in a free_cued recall task with semantic encoding in AD_annotated_ann.json
25736510	J Geriatr Psychiatry Neurol	161	143	18	./anns_v2/Lee et al., (2015) - Functional neuroanatomical correlates of the FAB in AD. A FDG PET study_annotated_ann.json
None	None	488	476	12	./anns_v2/Li et al., (2012) - The neuronal correlates of digits backward are revealed by VBM and RS-FMRI_annotated_ann.json
None	None	144	139	5	./anns_v2/Lin et al., (2014) - Cingulum correlates of cognitive functions in MCI and AD_annotated_ann.json
None	None	293	272	21	./anns_v2/Migo et al., (2015) Aging Neuropsychology and Cognition_annotated_ann.json
19296551	Int J Geriatr Psychiatry	258	235	23	./anns_v2/Melrose et al., (2009) - The neural correlates of naming and fluency deficits in AD_annotated_ann.json
21055445	Neurosci Lett	112	98	14	./anns_v2/Matsuoka et al., (2011) - Neural correlates of performance on the different scoring systems of the CDT_annotated_ann.json
21783205	J Neurol Sci	139	129	10	./anns_v2/Moriyama et al., (2011) - Increased dopamine transported density in PD with SAD_annotated_ann.json
26163801	Neuroimage	289	289	0	./anns_v2/Lin, Chiu _ Gramann (2015) - EEG correlates of spatial orientation in human retrosplenial complex_annotated_ann.json
None	None	174	172	2	./anns_v2/Mortimer et al., (2004) - Delated recall, hippocampal volume and AD_annotated_ann.json
24270207	J Alzheimers Dis	219	209	10	./anns_v2/Murray et al., (2014) - Hyperphosphorylated tau is elevated in AD with psychosis_annotated_ann.json
26178812	Geriatr Gerontol Int	159	148	11	./anns_v2/Nakashima et al., (2016) - Neuroanatomical correlates of error types on CDT in AD_annotated_ann.json
27180794	J Nippon Med Sch	352	339	13	./anns_v2/Nielson et al., (1996) - Constructional apraxia in AD_annotated_ann.json
24736891	J Cereb Blood Flow Metab	193	179	14	./anns_v2/Nishi et al., (2008) - Correlation between cognitive deficits and glucose hypometabolism in MCI_annotated_ann.json
20162494	Clin Neuropsychol	236	226	10	./anns_v2/Oosterman et al., (2010) - Assessing mental flexibility. Neuroanatomical and psychological correlates of TMT_annotated_ann.json
18841015	Dement Geriatr Cogn Disord	143	127	16	./anns_v2/Nagahama et al., (2005) - Neural correlates of impaired performance on clock drawing test in AD_annotated_ann.json
23563962	Cereb Cortex	378	376	2	./anns_v2/Nee et al., (2014) - Prefrontal cortex organisation. Dissociating effects of temporal abstraction, relational abstraction and integration with fMRI_annotated_ann.json
15661114	Clin Neurophysiol	213	196	17	./anns_v2/Nobili et al., (2005) - Resting SPECT correlation in very mild AD_annotated_ann.json
26329118	Psychiatry Res	193	187	6	./anns_v2/Oh et al., (2015) - The neural basis of a deficit in abstract thinking in patients with schizophrenia_annotated_ann.json
27288777	J Neurol Sci	166	150	16	./anns_v2/Ostergaard et al., (2002) - Effects of DBS of the STN in Patients with PD and Motor Fluctuations_annotated_ann.json
20402571	Int J Neurosci	177	173	4	./anns_v2/Parks et al., (2010) - Performance on the CDT correlates with fMRI response to a visuopstial task in AD_annotated_ann.json
27683905	J Neurosci	697	697	0	./anns_v2/Patterson et al., (2007) - Representation of semantic knowledge in the human brain_annotated_ann.json
22809566	Exp Neurol	246	234	12	./anns_v2/Pedrosa et al., (2012) - Essential tremor and tremor in PD are associated with distinct tremor clusters in ventral thalamus_annotated_ann.json
None	None	172	166	6	./anns_v2/Palmer et al., (1995) - Postural finger tremor exhibited by PD and healthy controls_annotated_ann.json
15135882	Neurosci Lett	88	81	7	./anns_v2/Pantel et al., (2004) - Distribution of cerebral atrophy assessed by MRI reflects patterns of neuropsychological deficits in AD_annotated_ann.json
25461208	Epilepsy Behav	273	273	0	./anns_v2/Peer et al., (2014) - Orientation and disorientation. Lessons from patients with epilepsy._annotated_ann.json
26090080	J Mov Disord	68	63	5	./anns_v2/Pellaprat et al., (2014) - Deep brain stimulation of STN improves pain in PD_annotated_ann.json
27687251	Acta Radiol	218	197	21	./anns_v2/Pasquini et al., (2016) - AD and memory_annotated_ann.json
None	None	132	114	18	./anns_v2/Perneczky et al., (2008) - Activities of daily living, cerebral glucose metabolism _ cognitive reserve in lewy body and PD_annotated_ann.json
26242705	Neurobiol Aging	229	218	11	./anns_v2/Peng et al., (2016) - Clinical and neuroimaging differences between posterior cortical atrophy and amnestic AD patients_annotated_ann.json
23792693	J Alzheimers Dis	181	168	13	./anns_v2/Perri et al., (2013) - Word list and story recall elicit different patterns of memory deficit in patients with AD_annotated_ann.json
26400852	Neuroradiology	179	159	20	./anns_v2/Pravata et al., (2016) - The neural correlates of anomia in the conversion from MCI to AD_annotated_ann.json
None	None	251	244	7	./anns_v2/Peters et al., (2009) - The neural correlates of verbal STM in AD_annotated_ann.json
26639978	Parkinsonism Relat Disord	117	106	11	./anns_v2/Ramirez-Ruiz et al., (2007) - Cerebral atrophy in PD with visual hallucinations_annotated_ann.json
17717413	Dement Geriatr Cogn Disord	166	159	7	./anns_v2/Rami et al., (2007) - Cortical brain metabolism as measured by H-MRS is related to memory in aMCI and AD_annotated_ann.json
27668883	PLoS One	327	296	31	./anns_v2/Remy et al., (2005) - Verbal episodic memory impairment in AD_annotated_ann.json
None	None	166	166	0	./anns_v2/Randhawa et al., (2013) - Clinical Study Repetitive Transcranial Magnetic Stimulation Improves Handwriting in Parkinson’s Disease_annotated_ann.json
24403280	J Neurol Neurosurg Psychiatry	268	259	9	./anns_v2/Robert et al., (2014) - Apathy and impaired emotional facial recognition networks overlap in PD._annotated_ann.json
26300385	Neuropsychologia	164	157	7	./anns_v2/Rogalski et al., (2011) - Anatomy of language impairments in primary progressive aphasia._annotated_ann.json
15931515	Eur J Nucl Med Mol Imaging	131	117	14	./anns_v2/Rodriguez et al., (2005) - Global cognitive impairment should be taken into account in SPECT-neuropsychology correlations in AD_annotated_ann.json
27062691	Brain Lang	292	285	7	./anns_v2/Rodriguez et al., (2016) - Neuroanatomical correlates of verbal fluency in early AD and normal aging_annotated_ann.json
None	None	197	185	12	./anns_v2/Rolinski et al., (2016) - Basal ganglia dysfuncion in REM sleeep behaviour disorder parallels that in PD_annotated_ann.json
26827646	Neurobiol Aging	105	93	12	./anns_v2/Rohrer et al., (2013) - Patterns of longitudinal brain atrophy in the logopenic variant of primary progressive aphasia_annotated_ann.json
20847406	J Alzheimers Dis	153	142	11	./anns_v2/Sarazin et al., (2010) - The amnestic syndrome of hippocampal type in AD. An MRI study_annotated_ann.json
26972578	Brain Imaging Behav	229	222	7	./anns_v2/Rombouts et al., (2005) - Altered resting state networks in MCI and AD. An fMRI study._annotated_ann.json
19819300	Neurosci Lett	103	89	14	./anns_v2/Schonknecht et al., (2009) - Neural correlates of delayed episodic memory in patients with MCI._annotated_ann.json
21675596	Clin EEG Neurosci	8	8	0	./anns_v2/Schonknecht et al., (2011) - Bihemispheric cerebral FDG PET correlates of cognitive dysfunction as assessed by the CERAD in AD_annotated_ann.json
22322075	Neurosci Lett	108	96	12	./anns_v2/Seidl et al., (2012) - Subcortical morphological correlates of impaired CDT performance_annotated_ann.json
23888166	Dement Geriatr Cogn Dis Extra	127	118	9	./anns_v2/Shindo et al., (2013) - Trail making test Part A and brain perfusion imaging in mild AD_annotated_ann.json
None	None	100	90	10	./anns_v2/Sakakibara et al., (2001) - SPECT imaging of the dopamine transport revealed marked decline of nigrostriatal dopaminergic function in PD with urinary dysfunctio_annotated_ann.json
11049667	Brain Lang	339	331	8	./anns_v2/Small et al., (2000) - Sentence repetition and processing resources in AD_annotated_ann.json
24670399	J Alzheimers Dis	134	117	17	./anns_v2/Sexton et al., (2010) - MRI correlates of episodic memory in AD, mild cognitive impairment and healthy aging._annotated_ann.json
10584671	Mov Disord	157	146	11	./anns_v2/Seinber et al., (1999) - Changes in Handwriting Resulting From Bilateral STN stimulation in PD_annotated_ann.json
23843193	Mov Disord	268	253	15	./anns_v2/Shin et al., (2012) - Neuroanatomical substrates of visual hallucinations in PD_annotated_ann.json
23673275	Neuroscience	139	127	12	./anns_v2/Shon et al., (2013) - Functional neuroanatomical correlates of CDT (CLOX) performance in AD_annotated_ann.json
26298389	Parkinsonism Relat Disord	188	178	10	./anns_v2/Smith et al., (2015) - ICDs and dopamine transporter imaging in PD._annotated_ann.json
15862203	Neuroimage	259	246	13	./anns_v2/Sun et al., (2005) - Age dependent brain activation during forward and backward digit recall revealed by fMRI_annotated_ann.json
27671247	J Rehabil Med	389	389	0	./anns_v2/Strien et al., (1988) - Finger tapping_annotated_ann.json
27690274	Eur J Neurosci	148	140	8	./anns_v2/Tan et al., (2015) - Pain in PD_annotated_ann.json
26117505	Soc Cogn Affect Neurosci	233	229	4	./anns_v2/Spunt et al., (2015) - The neural basis of conceptualizing the same action at different levels of abstraction_annotated_ann.json
22709794	Parkinsonism Relat Disord	258	236	22	./anns_v2/Sturman et al., (2004) - Effects of subthalamic nucleus stimulation and medication on resting and postural tremor in PD_annotated_ann.json
25869859	Neuroimage	151	151	0	./anns_v2/Spitzer et al., (1998) - fMRI of category-specific cortical activation._annotated_ann.json
25649022	Neurobiol Aging	174	167	7	./anns_v2/Smith et al., (2015) - The role of pallidal serotonergic function in PD dyskinesias. A PET study._annotated_ann.json
27679573	Front Pharmacol	129	116	13	./anns_v2/Tessitore et al., (2016) - Fatigue in PD_annotated_ann.json
23938134	Parkinsonism Relat Disord	141	131	10	./anns_v2/Sunwoo et al., (2013) - Thalamic volume and related visual recognition are associated with FOG in PD_annotated_ann.json
23830931	Psychiatry Res	181	170	11	./anns_v2/Terada et al., (2013) - Trail making test B and brain perfusion imaging in MCI and AD_annotated_ann.json
None	None	133	117	16	./anns_v2/Toledo-Morrell et al., (2000) - Hemispheric difference in hippocampal volume predict verbal and spatial memory performance in patients with AD_annotated_ann.json
18763875	Neuropsychology	199	195	4	./anns_v2/Tranel et al., (2008) - Does the clock drawing test have focal neuroanatomical correlates._annotated_ann.json
21831859	Am J Alzheimers Dis Other Demen	150	150	0	./anns_v2/Tsai et al., (2011) - Posterior cortical atrophy. Evidence for discrete syndromes of early onset AD_annotated_ann.json
None	None	182	166	16	./anns_v2/Tijms et al., (2014) - Single subject GM graph properties and their relationship with cognitive impairment in AD_annotated_ann.json
25446003	Brain Res	277	272	5	./anns_v2/Tomasino et al., (2014) - How do conceptual representations interact with processing demands. An FMRI study on action and abstract related words_annotated_ann.json
None	None	248	241	7	./anns_v2/Vasconcelos et al., (2013) - The thickness of posterior cortical areas is related to executive dysfunction in AD_annotated_ann.json
27618110	Brain Sci	148	141	7	./anns_v2/Voon et al., (2013) - Impulse control disorders in PD_annotated_ann.json
15802915	Dement Geriatr Cogn Disord	99	91	8	./anns_v2/Ueda et al., (2002) - Clock drawing performance and rCBF in AD_annotated_ann.json
24672452	Front Behav Neurosci	102	95	7	./anns_v2/Vlcek _ Laczo (2014) - Neural correlates of spatial navigation changes in MCI and AD_annotated_ann.json
27679483	Brain	8	7	1	./anns_v2/Welsh et al., (1994) - Neural correlates of dementia_annotated_ann.json
24484280	Curr Alzheimer Res	147	128	19	./anns_v2/Weiler et al., (2014) - Default mode, EF and language functional connectivity networks are compromised in AD_annotated_ann.json
21446782	Int J Neurosci	161	148	13	./anns_v2/Weis et al., (2011) - Functional neuoanatomy of sustained memory encoding performance in healthy aging and AD_annotated_ann.json
20069587	Int J Geriatr Psychiatry	206	200	6	./anns_v2/Woo et al., (2009) - Executive deficits and regional brain metabolism in AD_annotated_ann.json
None	None	193	183	10	./anns_v2/Winge et al., (2005) - Relationships between nigrostriatal dopaminergic degeneration, urinary symptoms and bladder control in PD._annotated_ann.json
27247279	J Neural Eng	199	186	13	./anns_v2/Wu et al., (2012) - Attention related networks in AD_annotated_ann.json
17954780	Neurology	156	150	6	./anns_v2/Xu et al., (2007) - Perfusion fMRI detects deficits in regional CBF during memory encoding tasks in MCI_annotated_ann.json
15752963	Clin Imaging	109	102	7	./anns_v2/Xie et al., (2005) - Patterns of brain activation in patients with mild AD during performance of substraction._annotated_ann.json
25995462	J Neurosci	254	249	5	./anns_v2/Wurm et al., (2015) - Decoding actions at different levels of abstraction_annotated_ann.json
26223260	Cereb Cortex	329	328	1	./anns_v2/Wurm et al., (2015) - Decoding concrete and abstract action representations during explicit and implicit conceptual processing_annotated_ann.json
24179826	Neuroimage Clin	284	272	12	./anns_v2/Woost et al., (2013) - Neural correlates of DemTect in AD and frontotemporal lobar degeneration._annotated_ann.json
20109475	Neuropsychologia	218	196	22	./anns_v2/Yakushev et al., (2010) - Increased hippocampal head diffusivity predicts impaired episodic memory performance in early AD_annotated_ann.json
22777857	Ann Nucl Med	329	313	16	./anns_v2/Yoon et al., (2012) - Correlation between neuropsychological tests and hypoperfusion in MCI_annotated_ann.json
22692580	Nucl Med Commun	194	178	16	./anns_v2/Yoon et al., (2012) - Significant correlation between cerebral hypoperfusion and neuropsychological assessment scores of patients with MCI_annotated_ann.json
25511330	Parkinsonism Relat Disord	217	208	9	./anns_v2/Yao et al., (2015) - Resting activity in visual and corticostriatal pathways in PD with hallucinations_annotated_ann.json
24593247	J Neuroimaging	153	152	1	./anns_v2/Yamashita et al., (2014) - Cerebral blood flow reduction associated with orientation for time in AD_annotated_ann.json
15598550	Psychiatry Res	220	209	11	./anns_v2/Zahn et al., (2004) - Hemispheric asymmetries of hypometabolism associated with semantic memory impairment in AD_annotated_ann.json
15929035	Ann Neurol	165	155	10	./anns_v2/Zarow et al., (2005) - Correlates of Hippocampal neuron number in AD and ischemic vascular dementia_annotated_ann.json
27661438	Epilepsy Res	143	143	0	./anns_v2/Zhang et al., (2009) - Impaired attention network in temporal lobe epilepsy_annotated_ann.json
25465747	Parkinsonism Relat Disord	155	140	15	./anns_v2/Zhang et al., (2015) - Akinetic-rigid and tremor-dominant PD patients show different patterns of instrinsic brain activity_annotated_ann.json
27459924	Neurobiol Aging	184	169	15	./anns_v2/Zhang et al., (2016) - Enhanced resting-state FC between core memory task activation peaks is associated with memory impairment in MCI_annotated_ann.json
19020671	Alzheimers Dement	218	218	0	./anns_v2/Zheng et al., (2014) - ED and GM atrophy in amnestic MCI_annotated_ann.json
23417856	Hum Brain Mapp	128	120	8	./anns_v2/Zheng et al., (2014) - DTI correlates of distinct cognitive impairments in PD_annotated_ann.json
16784724	Brain Res	258	254	4	./anns_v2/Zhou et al., (2006) - Neural substrates for forward and backward recitation of numbers._annotated_ann.json
26842545	Parkinsonism Relat Disord	172	148	24	./anns_v2/Zhou et al., (2016) - Substantia nigra echohenicity correlated with clinical features of PD_annotated_ann.json
